    ********************************
   *-------------------------------*
  *--------------------------------*
**-------------------------B------>*
*------------------------***********
*----------------****----***********
*<-------o----*----------***********
**************-----------***********
//
