    ********************************
   *-------------------------------*
  *--------------------------------*
**----B--------------------B------>*
*----********------------***********
*---**********-----------***********
*<--**********--o--------***********
************************************
//
