************************************
*----------------------------------*
*b---------------------------------*
***-----------------------pp********
*------------------------p---*******
******---****************-----******
*-------*B-B-B-B-B-B-B-B-*-----*****
*------p-B-B-B-B-B-B-B-B-Bp--------*
*<----pB-B-B-B-B-B-B-B-B-B-p------>*
************************************
//
1 2 b 7 7 6 8 25 4 26 3 27 3 26 7 27 8