*************************************
*-----------------------------------*
*-----------------------------------*
*--------------B-B------------------*
*-----------------------------------*
*<--------------B------------------>*
*******--***--****--****--***********
*******--***--****--****--***********
*******ss***ss****ss****ss***********
*************************************
//