*****************************
*---------------------------*
*--BB-----------------------*
*<--B-----------h---------->*
*****************************
//