*************************************
*BBp--------------------------------*
*BBp--------------------------------*
****-----------B-B------------------*
*-----------------------------------*
*<----b---------B------------------>*
*******pp***pp****pp****pp***********
*******--***--****--****--***********
*******ss***ss****ss****ss***********
*************************************
//
6 5 b 3 1 3 2 6 7 6 8 6 12 6 13 6 18 6 19 6 24 6 25 6